SO  ./assets/new_1.png
NO  ./assets/new_2.png
EA  ./assets/new_3.png
WE  ./assets/new_4.png

C 128, 128, 255
F 50, 50, 50


        1111111111111111111111111
        1000000000110000000000001
        1011000001110000000000001
        1001000000000000000000001
111111111011000001110000000000001
100000000011000001110110011111111
11110111111111011100000000001
11110111111111011101010010001
11000000110101011100000010001
10000000000000001100000010001
10000000000000001101010010001
11000001110101011111011110W0111
11110111 1110101 101111010001
11111111 1111111 111111111111