SO  ./assets/wall_1.png
NO  ./assets/wall_2.png
WE  ./assets/wall_4.png
EA  ./assets/wall_3.png

C 128, 128, 255
F 50, 50, 50

11111111111111111111111111111
100000000000000000000000000001
11111111111111111111111111111


                    11111111111111111              
                    100S0000000000001           
                    10000000000000001          
                    10000000000000001 
                    100000000000000011
         1           110000001000000001
        101            10000101000000001
         1          1110000001000000001
                    1000000000000000111
                    10000000000000001
                    10000000000000001
                    11111111111111111