SO  ./assets/wall_1.png
NO  ./assets/wall_2.png
WE  ./assets/wall_4.png
EA  ./assets/wall_3.png

C 128, 128, 255
F 50, 50, 50


1111111111111111111111111111111111111111
1000000000000001000010000100001000000001
1000000000000001000010000100001000000001
1000000000000001000010000100001000000001
1000000000000001000010000100001000000001
1000000000000001000010000100001000000001
1000000000000000000000000000000000000001
1000000000000000000000000000000000000001
1000000000000000000000000000000000000001
1000000000000000000000000000000000000001
1000000000000000000000000000000000000001
1000000000000000000000000000100000000001
1000000000000000000000000001000000000001
1000000000000000000000010000000000000001
1000000000000000000000001000000000000001
1000010000100000000000000000000000010001
1000010000100000000000000000000000010001
1000010000100N00000000000000000000010001
1000010000100000000000000000000000010001
1000010000100000000000000000000000010001
1111111111111111111111111111111111111111