SO  ./assets/wall_1.png
NO  ./assets/wall_2.png
WE  ./assets/wall_4.png
EA  ./assets/wall_3.png

C 128, 128, 255
F 50, 50, 50


1111111111111111     111111111111111111
1000000000000001      111000000000001111
1000000000000001111111111000000000001111
1000000000000000000000000000000000001111
1000000000000000000000000000000N00001111
10000000000000000000000000000000000001111
100000000000000000000000000000000000001111
1000000000000001111111111000000000001111
1000011110000001       111000000000001111
1000000000000001      111000001111001111
1000000000000001      111000000000001111
1000000000000001      111000000000001111
1000000000000001      111000000000001111
1011110001111001      111000000000001111
1000000000000001      111000000000001111
1000000000000001      111000000000001111
1111111111111111     111111111111111111